12
1
24
2 0 2 1 3 1 4 1 5 1 6 1 7 1 8 1 8 2 8 3 8 4 8 5 7 5 6 5 5 5 4 5 3 5 3 6 3 7 3 8 4 8 5 8 6 8 6 9
6
14 9 13 9 14 8 14 7 14 6 14 4
3
30 1 1 1 0 1 1 1 1 2 0 0 0 1 1 2 2 2 0 0 1 2 1 2 1 2 0 2 2 2 2
30 2 2 2 0 0 0 2 2 2 0 0 0 2 2 2 0 0 0 2 2 2 2 2 2 2 0 2 2 2 2
45 1 1 1 1 1 1 1 1 1 2 2 2 2 0 2 2 1 1 1 1 1 1 1 2 2 2 2 2 2 2 0 0 0 0 2 2 2 2 2 2 2 2 2 2 2