18
1
29
3 0  3 1  3 2  3 3  3 4  3 5  3 6   3 7  4 7  5 7  6 7  6 6  6 5  6 4  6 3   7 3  8 3  9 3  10 3  11 3  11 4  11 5  11 6  11 7  10 7  9 7  8 7  8 8  8 9
21
1 0  4 0  5 0  6 0  7 0  8 0  9 0  10 0   5 1  6 1  8 1  10 1   11 0  13 0  14 0    12 4  9  4   0 9  3 9  2 7  1 5
4
25 1 1 1 0 1 1 1 1 2 0 0 0 1 1 2 2 2 0 0 1 2 1 2 1 2
25 2 2 2 3 3 3 2 2 2 0 0 0 2 2 2 0 3 0 2 2 2 2 2 2 2
30 1 3 1 3 1 3 1 3 1 2 2 2 2 0 2 2 1 1 3 3 3 1 1 2 2 2 2 4 0 4
15 5 0 3 0 0 5 0 0 0 5 0 0 0 0 6