15
1
32
2 0  2 1  2 2  3 2  4 2  5 2  6 2  7 2  8 2  9 2  10 2  11 2  12 2  13 2  13 3  13 4  13 5  13 6  13 7   12 7  11 7   10 7  10 6  10 5  9 5  8 5  7 5  7 6  7 7  6 7  6 8  6 9
21
3 0  4 0  5 0  6 0  7 0  8 0  9 0  10 0   0 8  1 7  13 9  12 8   11 0  13 0  14 0    11 3  9  3   0 9  3 9  2 7  1 5
5
25 1 1 1 1 1 0 2 2 2 2 0 3 3 1 2 2 2 1 2 3 3 3 1 1 1
15 2 2 2 2 2 0 1 1 1 3 1 3 1 3 3
20 2 3 1 3 0 0 4 4 0 3 0 2 0 4 3 3 0 0 0 4
10 4 0 0 4 0 0 4 0 0 4
20 4 0 3 0 5 3 0 3 0 3 0 3 3 0 3 0 5 0 3 3