12
1
32
3 0 3 1 3 2 3 3 4 3 5 3 6 3 7 3 8 3 9 3 10 3 11 3 12 3 13 3 13 4 13 5 12 5 11 5 10 5 10 6 10 7 10 8 9 8 8 8 7 8 7 7 7 6 6 6 5 6 5 7 5 8 5 9
10
0 9 1 9 2 9 0 8 0 7 14 0 13 0 14 9 0 0 1 0
4
25 1 1 1 0 1 3 3 3 2 3 2 3 1 1 2 2 2 0 0 1 2 1 2 1 2
25 2 2 2 0 0 0 2 2 2 0 3 3 2 2 2 0 3 3 2 2 2 2 4 4 2
30 1 1 1 3 3 3 3 4 1 2 2 2 2 0 2 2 1 1 3 3 3 3 3 2 4 2 4 2 4 2
5 3 3 4 4 4