15
1
23
2 0 2 1 2 2 3 2 4 2 5 2 5 3 5 4 6 4 7 4 8 4 9 4 10 4 10 5 10 6 10 7 10 8 9 8 8 8 7 8 6 8 5 8 5 9
5
14 0 13 0 12 0 14 1 10 0
3
25 1 1 1 0 1 1 1 1 2 0 0 0 1 1 2 2 2 0 0 1 2 1 2 1 2
25 2 2 2 0 0 0 2 2 2 0 0 0 2 2 2 0 0 0 2 2 2 2 2 2 2
30 1 1 1 1 1 1 1 1 1 2 2 2 2 0 2 2 1 1 1 1 1 1 1 2 2 2 2 2 2 2